"filename", "language", "Ini", "Java", "HTML", "comment", "blank", "total"
"i:\マイドライブ\PRR2_TIM20_Tim_Högberg\slutprojekt\basic-srs\src\main\AddCard\AddCardView.java", "Java", 0, 138, 0, 9, 16, 163
"i:\マイドライブ\PRR2_TIM20_Tim_Högberg\slutprojekt\basic-srs\src\main\AddCard\AddCardWindow.java", "Java", 0, 19, 0, 0, 6, 25
"i:\マイドライブ\PRR2_TIM20_Tim_Högberg\slutprojekt\basic-srs\src\main\AddDeck\AddDeckView.java", "Java", 0, 37, 0, 2, 9, 48
"i:\マイドライブ\PRR2_TIM20_Tim_Högberg\slutprojekt\basic-srs\src\main\AddDeck\AddDeckWindow.java", "Java", 0, 14, 0, 0, 4, 18
"i:\マイドライブ\PRR2_TIM20_Tim_Högberg\slutprojekt\basic-srs\src\main\CardReviewer\CardReviewView.java", "Java", 0, 14, 0, 0, 5, 19
"i:\マイドライブ\PRR2_TIM20_Tim_Högberg\slutprojekt\basic-srs\src\main\CardReviewer\CardReviewWindow.java", "Java", 0, 16, 0, 1, 7, 24
"i:\マイドライブ\PRR2_TIM20_Tim_Högberg\slutprojekt\basic-srs\src\main\CardReviewer\WebViewer.java", "Java", 0, 25, 0, 0, 7, 32
"i:\マイドライブ\PRR2_TIM20_Tim_Högberg\slutprojekt\basic-srs\src\main\CardReviewer\desktop.ini", "Ini", 7, 0, 0, 0, 0, 7
"i:\マイドライブ\PRR2_TIM20_Tim_Högberg\slutprojekt\basic-srs\src\main\CardTypeManager\CardTypeFields\CardTypeFieldsView.java", "Java", 0, 123, 0, 7, 12, 142
"i:\マイドライブ\PRR2_TIM20_Tim_Högberg\slutprojekt\basic-srs\src\main\CardTypeManager\CardTypeFields\CardTypeFieldsWindow.java", "Java", 0, 19, 0, 1, 6, 26
"i:\マイドライブ\PRR2_TIM20_Tim_Högberg\slutprojekt\basic-srs\src\main\CardTypeManager\CardTypeFields\desktop.ini", "Ini", 7, 0, 0, 0, 0, 7
"i:\マイドライブ\PRR2_TIM20_Tim_Högberg\slutprojekt\basic-srs\src\main\CardTypeManager\CardTypeManagerView.java", "Java", 0, 135, 0, 4, 19, 158
"i:\マイドライブ\PRR2_TIM20_Tim_Högberg\slutprojekt\basic-srs\src\main\CardTypeManager\CardTypeManagerWindow.java", "Java", 0, 17, 0, 1, 5, 23
"i:\マイドライブ\PRR2_TIM20_Tim_Högberg\slutprojekt\basic-srs\src\main\CardTypeManager\CardTypeStyle\CardTypeStyleView.java", "Java", 0, 183, 0, 9, 23, 215
"i:\マイドライブ\PRR2_TIM20_Tim_Högberg\slutprojekt\basic-srs\src\main\CardTypeManager\CardTypeStyle\CardTypeStyleWindow.java", "Java", 0, 26, 0, 1, 4, 31
"i:\マイドライブ\PRR2_TIM20_Tim_Högberg\slutprojekt\basic-srs\src\main\CardTypeManager\CardTypeStyle\desktop.ini", "Ini", 7, 0, 0, 0, 0, 7
"i:\マイドライブ\PRR2_TIM20_Tim_Högberg\slutprojekt\basic-srs\src\main\CardTypeManager\desktop.ini", "Ini", 7, 0, 0, 0, 0, 7
"i:\マイドライブ\PRR2_TIM20_Tim_Högberg\slutprojekt\basic-srs\src\main\Data\BackSide.java", "Java", 0, 11, 0, 0, 4, 15
"i:\マイドライブ\PRR2_TIM20_Tim_Högberg\slutprojekt\basic-srs\src\main\Data\Card.java", "Java", 0, 10, 0, 1, 4, 15
"i:\マイドライブ\PRR2_TIM20_Tim_Högberg\slutprojekt\basic-srs\src\main\Data\CardSide.java", "Java", 0, 10, 0, 0, 4, 14
"i:\マイドライブ\PRR2_TIM20_Tim_Högberg\slutprojekt\basic-srs\src\main\Data\CardType.java", "Java", 0, 157, 0, 23, 29, 209
"i:\マイドライブ\PRR2_TIM20_Tim_Högberg\slutprojekt\basic-srs\src\main\Data\Deck.java", "Java", 0, 30, 0, 0, 9, 39
"i:\マイドライブ\PRR2_TIM20_Tim_Högberg\slutprojekt\basic-srs\src\main\Data\Field.java", "Java", 0, 36, 0, 9, 10, 55
"i:\マイドライブ\PRR2_TIM20_Tim_Högberg\slutprojekt\basic-srs\src\main\Data\FrontSide.java", "Java", 0, 11, 0, 0, 3, 14
"i:\マイドライブ\PRR2_TIM20_Tim_Högberg\slutprojekt\basic-srs\src\main\Data\desktop.ini", "Ini", 7, 0, 0, 0, 0, 7
"i:\マイドライブ\PRR2_TIM20_Tim_Högberg\slutprojekt\basic-srs\src\main\GridbagWizard.java", "Java", 0, 14, 0, 15, 8, 37
"i:\マイドライブ\PRR2_TIM20_Tim_Högberg\slutprojekt\basic-srs\src\main\HTML\desktop.ini", "Ini", 7, 0, 0, 0, 0, 7
"i:\マイドライブ\PRR2_TIM20_Tim_Högberg\slutprojekt\basic-srs\src\main\HTML\mainWindow.html", "HTML", 0, 0, 73, 0, 4, 77
"i:\マイドライブ\PRR2_TIM20_Tim_Högberg\slutprojekt\basic-srs\src\main\HTML\test.html", "HTML", 0, 0, 48, 2, 7, 57
"i:\マイドライブ\PRR2_TIM20_Tim_Högberg\slutprojekt\basic-srs\src\main\Helper\FileReader.java", "Java", 0, 19, 0, 3, 4, 26
"i:\マイドライブ\PRR2_TIM20_Tim_Högberg\slutprojekt\basic-srs\src\main\Helper\HtmlHelper.java", "Java", 0, 21, 0, 6, 3, 30
"i:\マイドライブ\PRR2_TIM20_Tim_Högberg\slutprojekt\basic-srs\src\main\Helper\OkCancelButtonsPanel.java", "Java", 0, 40, 0, 0, 10, 50
"i:\マイドライブ\PRR2_TIM20_Tim_Högberg\slutprojekt\basic-srs\src\main\Helper\desktop.ini", "Ini", 7, 0, 0, 0, 0, 7
"i:\マイドライブ\PRR2_TIM20_Tim_Högberg\slutprojekt\basic-srs\src\main\MW\DeckList.java", "Java", 0, 40, 0, 10, 5, 55
"i:\マイドライブ\PRR2_TIM20_Tim_Högberg\slutprojekt\basic-srs\src\main\MW\ListPopup.java", "Java", 0, 26, 0, 4, 5, 35
"i:\マイドライブ\PRR2_TIM20_Tim_Högberg\slutprojekt\basic-srs\src\main\MW\MWMenuBar.java", "Java", 0, 24, 0, 0, 8, 32
"i:\マイドライブ\PRR2_TIM20_Tim_Högberg\slutprojekt\basic-srs\src\main\MW\MainContentView.java", "Java", 0, 73, 0, 4, 11, 88
"i:\マイドライブ\PRR2_TIM20_Tim_Högberg\slutprojekt\basic-srs\src\main\MW\MainWindow.java", "Java", 0, 162, 0, 29, 23, 214
"i:\マイドライブ\PRR2_TIM20_Tim_Högberg\slutprojekt\basic-srs\src\main\MW\MainWindowView.java", "Java", 0, 35, 0, 3, 7, 45
"i:\マイドライブ\PRR2_TIM20_Tim_Högberg\slutprojekt\basic-srs\src\main\MW\Menu.java", "Java", 0, 19, 0, 4, 11, 34
"i:\マイドライブ\PRR2_TIM20_Tim_Högberg\slutprojekt\basic-srs\src\main\MW\MyListCellRenderer.java", "Java", 0, 24, 0, 3, 7, 34
"i:\マイドライブ\PRR2_TIM20_Tim_Högberg\slutprojekt\basic-srs\src\main\MW\desktop.ini", "Ini", 7, 0, 0, 0, 0, 7
"i:\マイドライブ\PRR2_TIM20_Tim_Högberg\slutprojekt\basic-srs\src\main\main.java", "Java", 0, 9, 0, 0, 3, 12
"Total", "-", 56, 1537, 121, 151, 302, 2167